TGCAGTGCTAGACGCAGGGCTCGAACTGAAGCTTTCTTT	CSARRRARTEAFF	TRBV20-1	TRBJ1-1
TGTGCCAGCAGCGGGCTACTAGCCAAAAACATTCAGTACTTC	CASSGLLAKNIQYF	TRBV9	TRBJ2-4
TGTGCCCAGAGGTCGGTCTCTGGAGCTAATGAAAAACTGTTTTTT	CAQRSVSGANEKLFF	TRBV28	TRBJ1-4
TGTGCCAGCAGCTTGGCGGTTCTGAGCCATAATTCACCCCTCCACTTT	CASSLAVLSHNSPLHF	TRBV5-4	TRBJ1-6
TGTGCCAGCAGCTTAGACTCTTACGTCAAGAATACGCAGTATTTT	CASSLDSYVKNTQYF	TRBV11-2	TRBJ2-3
TGTGCCAGCAGTTGTACCACCCGCAGGGAAAGGAACAGCGCTAATGAAAAACTGTTTTTT	CASSCTTRRERNSANEKLFF	TRBV27	TRBJ1-4
TGTGCCAGCAGCTCGCAGGGGGTTTCTTTCGGGACAACTAATGAAAAACTGTTTTTT	CASSSQGVSFGTTNEKLFF	TRBV9	TRBJ1-4
TGTGCCAGCAGTAGGGCGAGTCCCTACGAGCAGTACTTC	CASSRASPYEQYF	TRBV12-3	TRBJ2-7
TGTGCCAGCAAGGTCTTGACAGGGGGCTTTATTTACGAGCAGTACTTC	CASKVLTGGFIYEQYF	TRBV27	TRBJ2-7
TGTGCCACCAGTGTGGAGGGGCTGGACCAGTACTTC	CATSVEGLDQYF	TRBV24-1	TRBJ2-5
TGTGCCAGCAGCCCTAGTGACGGGGGGACCTACAATGAGCAGTTCTTC	CASSPSDGGTYNEQFF	TRBV13	TRBJ2-1
TGTGCTAGCAGCTCCGGGACTAGCGGGGGGGCTAATGAGACCCAGTACTTC	CASSSGTSGGANETQYF	TRBV7-7	TRBJ2-5
TGCGCCAGCAAACGTTCGGGAACTGACGAGCAGTACTTC	CASKRSGTDEQYF	TRBV10-1	TRBJ2-7
TGCGCCAGCAGAGGACTAACCGGGACAGGGGGCGCGTGGCAGCCCCAGCATTTT	CASRGLTGTGGAWQPQHF	TRBV10-1	TRBJ1-5
TGTGCCAGCAGTGGTTCAGGGATGCAGCCCCAGCATTTT	CASSGSGMQPQHF	TRBV6-8	TRBJ1-5
TGTGCCAGCTCACCACCAGGAGTGACAGGGGAATTCACAGATACGCAGTATTTT	CASSPPGVTGEFTDTQYF	TRBV18	TRBJ2-3
TGTGCCAGCAGCATTTTGATACTAGCGGGGTCCTCTCTGCAAGAGACCCAGTACTTC	CASSILILAGSSLQETQYF	TRBV5-4	TRBJ2-5
TGTGCCAGCAGCTTGGCCGGGGAGCCACTTGGCAATAGCTCCTACGAGCAGTACTTC	CASSLAGEPLGNSSYEQYF	TRBV5-6	TRBJ2-7
TGTGCCACCAGTAGCGGGACTGCTGTTCATGGCTACACCTTC	CATSSGTAVHGYTF	TRBV24-1	TRBJ1-2
TGTGCCAGCAGTTACATCGACAGTCACACTGAAGCTTTCTTT	CASSYIDSHTEAFF	TRBV6-3	TRBJ1-1
